NO ./Texture/ahmez-za
SO ./Texture/mabdelou
WE ./Texture/wall-3d
EA ./Texture/wall-3d

F 220,100,0
C 225,30,0

11111111111111
   111111000001111111111111
   1000001010101010101011101
  11110000000000000000000001
 1000000000000000000000011
  100000000000000000000001
   100000000000000000000001
    10000000000N000000000001
     100000000000000000000001
      100000000000000000000001
      111111111111111111111111