NO ./texture/ahmez-za
SO ./texture/mabdelou
WE ./texture/sort_black_screen
EA ./texture/wall-3d

F 220,100,0
C 225,30,0

1111111111111111111
1000000000000000001
1E00000000000000001
1110111111111111111
1000000000000000001
1111111110111111111
1000000000000000001
1111111111111111111
